.....#############################....################################################################################
.#######.............#############.###################################################################################
.#######.###########.#############.#######################......................######################################
.........###########.#####................################.####################################..........#############
####################.#####.##############.################.......##############################.######################
####################.#####.##############.........########.#####.##############################.######################
####################.#####.##############.#######.########.#####.#######################.............#################
###############......#####.##############.#######.########.#####.#######################.###########.#################
###############.##########.##############.#######..........#####.#######################.###########.#################
###############.##########.########.......######################.#######################.###########.#################
###############.##########.########.############################................########.###########..........########
###############............########.####################################################.#############################
###################################.#################################....................#############################
###################################.#################################.################################################
###################################...................................################################################
##############################################.#######################################################################
##############################################.#####################.###########............##########################
##############################################.#################...........#####.##########.##########################
##############################################.###########################.#####.##########.##########################
##############################################.###########################.#####.##########.##########################
#########.............##############..................................####.#####.##########.##########################
#########.###########.##############.################################.####.#####.##########.##########################
#########.###########.##############.################################.####.#####.##########.##########################
#########.###########................################################............##########.##########################
#########.#################################################################################.##########################
#########.##############################################................###################.##########################
#########......................#########################.##############.###########.........##########################
#################.############.#########################.##############.##############################################
#################.############.#########################.##############.##############################################
#######.#########.############.#########################.##############.##############################################
#######.#########.############.#########################.##############.##############################################
#######.#########.############.#########################.##############.##############################################
#######...........############.#########################.##############.##############################################
#######.######################...........................##############.##############################################
#######.######################.########################################.##############################################
#######.######################.############..........##################.##############################################
#######.................######.......######.########.##################...........####################################
##############################.#####.######.########.############################.####################################
##############################.#####.######.########.############################.####################################
#############..................#####........########.############################.####################################
####################################.###############.############################.####################################
#########...........################.###############.##########...................####################################
##############.####.################################.##########.######################################################
##############.####.#########........................##########.######################################################
##############.####.###########################################.##########.....................#######################
##############.####.###########################################.##########.###################.#######################
##############.####.............................................##########.###################.#######################
##############.#############################.#############################.###################...................#####
##############............##################...............................#####################################.#####
################################################################################################################......

